{
    "level1":[    
        [0, 0, 4, 4, 4, 0, 0],
        [0, 4, 1, 1, 1, 4, 4],
        [4, 1, 1, 5, 1, 1, 1],
        [0, 1, 1, 1, 1, 1, 4],
        [0, 4, 1, 9, 1, 1, 0],
        [0, 0, 4, 4, 4, 4, 0]
    ],
    "level2":[    
        [0, 0, 0, 0, 0, 0, 0],
        [0, 4, 1, 1, 1, 4, 4],
        [4, 1, 1, 5, 1, 1, 1],
        [0, 1, 1, 1, 1, 1, 4],
        [0, 4, 1, 9, 1, 1, 0],
        [0, 0, 4, 4, 4, 4, 0]
    ]
}