{
    "level 1":[    
        [0, 0, 4, 4, 4, 0, 0, 0],
        [0, 4, 1, 1, 1, 4, 4, 0],
        [4, 1, 1, 5, 1, 1, 1, 0],
        [0, 1, 1, 1, 1, 1, 4, 0],
        [0, 4, 1, 9, 1, 1, 0, 0],
        [0, 0, 4, 4, 4, 4, 0, 0],
        [0, 0, 0, 0, 0, 0, 0, 0]
    ],
    "level 2":[
        [0, 4, 4, 4, 4, 4, 4],
        [0, 1, 5, 1, 1, 5, 0],
        [4, 1, 1, 1, 1, 1, 0],
        [4, 1, 1, 1, 1, 0, 0],
        [4, 4, 1, 1, 1, 1, 4],
        [0, 4, 9, 1, 4, 4, 0],
        [0, 0, 4, 4, 0, 0, 0]
    ],
    "level 3":[
        [0, 4, 4, 4, 4, 4, 4, 0],
        [0, 4, 4, 1, 1, 1, 1, 4],
        [0, 4, 1, 5, 1, 5, 1, 4],
        [0, 4, 1, 1, 1, 1, 1, 4],
        [4, 1, 1, 1, 1, 5, 1, 4],
        [0, 4, 1, 9, 1, 1, 4, 4],
        [0, 4, 4, 1, 1, 4, 0, 0],
        [0, 0, 4, 4, 4, 0, 0, 0]
    ],
    "level 4":[
        [0, 0, 0, 0, 0, 0, 0],
        [9, 1, 1, 1, 5, 4, 0],
        [0, 4, 6, 1, 1, 1, 4],
        [1, 1, 1, 1, 1, 1, 4],
        [5, 1, 1, 1, 5, 1, 4],
        [0, 1, 1, 1, 0, 0, 1]
    ],
    "level 5":[
        [0, 4, 4, 4, 4, 4, 4, 0, 0, 0],
        [0, 4, 1, 1, 1, 4, 4, 4, 4, 0],
        [4, 5, 1, 1, 1, 1, 1, 1, 4, 0],
        [4, 1, 1, 1, 1, 1, 1, 5, 1, 0],
        [4, 1, 1, 1, 1, 1, 1, 1, 1, 0],
        [0, 4, 4, 1, 1, 9, 1, 5, 0, 0],
        [0, 0, 4, 1, 1, 1, 1, 1, 1, 0],
        [0, 0, 0, 1, 1, 1, 0, 1, 0, 0],
        [0, 0, 0, 0, 0, 0, 0, 0, 0, 0]
    ],
    "level 6":[
        [0, 0, 0, 0, 0, 0, 0],
        [0, 4, 4, 4, 4, 4, 0],
        [0, 5, 1, 1, 1, 4, 0],
        [0, 0, 0, 1, 1, 0, 0],
        [4, 1, 1, 1, 1, 1, 4],
        [4, 1, 9, 1, 5, 1, 4],
        [0, 4, 1, 1, 1, 1, 0],
        [0, 0, 4, 4, 0, 0, 0]
    ]
}
