{
  "level 01": {
    "layout": [
      [0, 0, 4, 4, 4, 0, 0, 0],
      [0, 4, 1, 1, 1, 4, 4, 0],
      [4, 1, 1, 5, 1, 1, 1, 0],
      [0, 1, 1, 1, 1, 1, 4, 0],
      [0, 4, 1, 9, 1, 1, 0, 0],
      [0, 0, 4, 4, 4, 4, 0, 0],
      [0, 0, 0, 0, 0, 0, 0, 0]
    ],
    "difficulty": "easy",
    "wizard": false
  },
  "level 02": {
    "layout": [
      [0, 4, 4, 4, 4, 4, 4],
      [0, 1, 5, 1, 1, 5, 0],
      [4, 1, 1, 1, 1, 1, 0],
      [4, 1, 1, 1, 1, 0, 0],
      [4, 4, 1, 1, 1, 1, 4],
      [0, 4, 9, 1, 4, 4, 0],
      [0, 0, 4, 4, 0, 0, 0]
    ],
    "difficulty": "easy",
    "wizard": false
  },
  "level 03": {
    "layout": [
      [0, 4, 4, 4, 4, 4, 4, 0],
      [0, 4, 4, 1, 1, 1, 1, 4],
      [0, 4, 1, 5, 1, 5, 1, 4],
      [0, 4, 1, 1, 1, 1, 1, 4],
      [4, 1, 1, 1, 1, 5, 1, 4],
      [0, 4, 1, 9, 1, 1, 4, 4],
      [0, 4, 4, 1, 1, 4, 0, 0],
      [0, 0, 4, 4, 4, 0, 0, 0]
    ],
    "difficulty": "medium",
    "wizard": false
  },
  "level 04": {
    "layout": [
      [0, 0, 0, 0, 0, 0, 0],
      [9, 1, 1, 1, 5, 4, 0],
      [0, 4, 1, 1, 1, 1, 4],
      [1, 1, 1, 1, 1, 1, 4],
      [5, 1, 1, 1, 5, 1, 4],
      [0, 1, 4, 1, 0, 0, 1],
      [0, 0, 0, 0, 0, 0, 0]
    ],
    "difficulty": "easy",
    "wizard": false
  },
  "level 05": {
    "layout": [
      [0, 4, 4, 4, 4, 4, 4, 0, 0, 0],
      [0, 4, 1, 1, 1, 4, 4, 4, 4, 0],
      [4, 5, 1, 1, 1, 1, 1, 1, 4, 0],
      [4, 1, 1, 1, 1, 1, 1, 5, 1, 0],
      [4, 1, 1, 1, 1, 1, 1, 1, 1, 0],
      [0, 4, 4, 1, 1, 9, 1, 5, 0, 0],
      [0, 0, 4, 1, 1, 1, 1, 1, 1, 0],
      [0, 0, 0, 1, 1, 1, 0, 1, 0, 0],
      [0, 0, 0, 0, 0, 0, 0, 0, 0, 0]
    ],
    "difficulty": "medium",
    "wizard": false
  },
  "level 06": {
    "layout": [
      [0, 0, 0, 0, 0, 0, 0],
      [0, 4, 4, 4, 4, 4, 0],
      [0, 5, 1, 1, 1, 4, 0],
      [0, 0, 0, 1, 1, 0, 0],
      [4, 1, 1, 1, 1, 1, 4],
      [4, 1, 9, 1, 5, 1, 4],
      [0, 4, 1, 1, 1, 1, 0],
      [0, 0, 4, 4, 0, 0, 0]
    ],
    "difficulty": "medium",
    "wizard": false
  },
  "level 07": {
    "layout": [
      [0, 4, 4, 4, 4, 4, 0],
      [0, 1, 1, 1, 5, 4, 0],
      [4, 1, 5, 1, 1, 1, 0],
      [4, 1, 1, 1, 1, 5, 4],
      [4, 9, 1, 1, 1, 1, 4],
      [0, 4, 1, 5, 4, 4, 0],
      [0, 4, 4, 4, 0, 0, 0]
    ],
    "difficulty": "medium",
    "wizard": false
  },
  "level 08": {
    "layout": [
      [0, 0, 4, 4, 4, 4, 0],
      [4, 1, 1, 1, 1, 1, 4],
      [4, 1, 5, 1, 5, 1, 4],
      [4, 9, 1, 1, 1, 1, 4],
      [4, 1, 1, 1, 5, 1, 4],
      [4, 1, 5, 1, 1, 1, 4],
      [0, 4, 4, 4, 4, 4, 0]
    ],
    "difficulty": "medium",
    "wizard": false
  },
  "level 09": {
    "layout": [
      [0, 0, 0, 4, 4, 4, 4, 0, 0],
      [0, 4, 1, 1, 5, 1, 1, 4, 0],
      [4, 1, 1, 1, 1, 5, 1, 1, 4],
      [4, 1, 9, 1, 1, 1, 5, 1, 4],
      [4, 1, 1, 5, 1, 1, 1, 1, 4],
      [0, 4, 1, 1, 1, 1, 5, 1, 4],
      [0, 0, 4, 4, 4, 4, 4, 4, 0]
    ],
    "difficulty": "hard",
    "wizard": false
  },
  "level 10": {
    "layout": [
      [0, 0, 0, 0, 0, 0, 0],
      [0, 4, 1, 5, 1, 4, 0],
      [4, 1, 1, 1, 1, 1, 4],
      [4, 1, 5, 9, 5, 1, 4],
      [4, 1, 1, 1, 1, 1, 4],
      [0, 4, 1, 5, 1, 4, 0],
      [0, 0, 0, 0, 0, 0, 0]
    ],
    "difficulty": "medium",
    "wizard": false
  },

"level 11": {
  "layout": [
    [0, 0, 4, 4, 4, 4, 4, 4, 0, 0],
    [0, 4, 1, 1, 1, 5, 1, 1, 4, 0],
    [0, 4, 5, 1, 5, 1, 1, 1, 4, 0],
    [4, 1, 1, 1, 1, 1, 5, 1, 1, 4],
    [4, 9, 1, 1, 1, 1, 1, 1, 1, 4],
    [4, 1, 1, 5, 1, 1, 1, 1, 1, 4],
    [0, 4, 1, 1, 1, 5, 1, 1, 4, 0],
    [0, 0, 4, 4, 4, 4, 4, 4, 0, 0]
  ],
  "difficulty": "hard",
  "wizard": false
},
"level 12": {
  "layout": [
    [4, 4, 4, 4, 4, 4, 4, 4, 4, 4, 4],
    [4, 1, 1, 1, 1, 1, 1, 1, 1, 1, 4],
    [4, 1, 5, 1, 5, 1, 5, 1, 5, 1, 4],
    [4, 1, 1, 1, 1, 1, 1, 1, 1, 1, 4],
    [4, 5, 1, 1, 9, 1, 1, 1, 5, 1, 4],
    [4, 1, 1, 1, 1, 1, 1, 1, 1, 1, 4],
    [4, 1, 5, 1, 1, 1, 1, 5, 1, 1, 4],
    [4, 4, 4, 4, 4, 4, 4, 4, 4, 4, 4]
  ],
  "difficulty": "hard",
  "wizard": false
},
"level 13": {
  "layout": [
    [0, 0, 0, 4, 4, 4, 4, 4, 0, 0, 0],
    [0, 4, 4, 4, 1, 1, 1, 4, 4, 4, 0],
    [0, 4, 1, 1, 1, 5, 1, 1, 1, 4, 0],
    [4, 1, 1, 1, 5, 1, 1, 5, 1, 1, 4],
    [4, 1, 1, 1, 1, 9, 1, 1, 1, 1, 4],
    [4, 1, 5, 1, 1, 1, 1, 1, 5, 1, 4],
    [0, 4, 1, 1, 1, 1, 1, 1, 1, 4, 0],
    [0, 4, 4, 4, 4, 1, 1, 4, 4, 4, 0],
    [0, 0, 0, 4, 4, 4, 4, 4, 0, 0, 0]
  ],
  "difficulty": "hard",
  "wizard": false
},
"level 14": {
  "layout": [
    [0, 0, 4, 4, 4, 4, 4, 0, 0],
    [0, 4, 1, 1, 5, 1, 1, 4, 0],
    [4, 1, 1, 1, 1, 1, 5, 1, 4],
    [4, 1, 1, 5, 9, 5, 1, 1, 4],
    [4, 1, 1, 1, 1, 1, 1, 1, 4],
    [0, 4, 1, 5, 1, 1, 5, 1, 4],
    [0, 0, 4, 4, 4, 4, 4, 0, 0]
  ],
  "difficulty": "hard",
  "wizard": false
},
"level 15": {
  "layout": [
    [0, 0, 4, 4, 4, 4, 4, 4, 4, 0, 0],
    [0, 4, 1, 1, 1, 1, 1, 1, 4, 4, 0],
    [4, 1, 5, 1, 5, 1, 5, 1, 1, 1, 4],
    [4, 1, 1, 1, 1, 1, 1, 5, 1, 1, 4],
    [4, 1, 1, 5, 9, 1, 1, 1, 1, 1, 4],
    [4, 1, 5, 1, 1, 1, 5, 1, 1, 1, 4],
    [4, 1, 1, 1, 1, 1, 1, 1, 5, 1, 4],
    [0, 4, 1, 5, 1, 1, 1, 1, 1, 4, 0],
    [0, 0, 4, 4, 4, 4, 4, 4, 4, 0, 0]
  ],
  "difficulty": "hard",
  "wizard": false
},
"level 16": {
  "layout": [
    [4, 1, 1, 5, 1, 9],
    [1, 1, 1, 1, 4, 1],
    [5, 4, 1, 1, 1, 1],
    [1, 1, 1, 1, 1, 4],
    [4, 1, 1, 5, 1, 1],
    [5, 1, 1, 1, 1, 4]
  ],
  "difficulty": "medium",
  "wizard": false
},
"level 17": {
  "layout": [
    [0, 0, 0, 4, 4, 4, 5, 4],
    [0, 0, 4, 1, 1, 1, 1, 4],
    [0, 4, 5, 3, 1, 1, 3, 4],
    [0, 1, 1, 1, 0, 0, 1, 1],
    [0, 1, 1, 1, 0, 0, 1, 4],
    [0, 4, 1, 0, 0, 0, 1, 4],
    [0, 1, 1, 1, 5, 1, 1, 3],
    [0, 1, 1, 7, 1, 1, 9, 1],
    [0, 0, 0, 0, 0, 0, 0, 0]
  ],
  "difficulty": "hard",
  "wizard": true
}
}
